11111111111
1P0C0000111
101C10001C1
11EC1000001
11111111111